NO ./texture/brown.xpm
SO ./texture/red.xpm
WE ./texture/grey1.xpm
EA ./texture/index.xpm

F 220, 100  , 200
C 225, 30,0

1111111111111111111111111
1100000000000000000000001
1000000000000000000000001
1S01000000000000000000001
1000000000000000000000001
1111111111111111111111111