NO ./texture/brown.xpm
SO ./texture/red.xpm
WE ./texture/grey1.xpm
EA ./texture/index.xpm

F 159, 159 , 	159
C 29, 89, 254

1111111111111111111111111
1N00000000110000000010001
1000000000000000000010001
1001000000000000111110001
1011000000000010000000001
10000000000000100000000011111
11111111111111100000000010001
11000000000010000000000000001
11000001111110000000000010001
10000000000000001100000010001
10000000000000001101010010001
1100000111010101111101111000111
11110111 1110101 111111110001
11111111 1111111 111111111111